{
  "mazes": [
    {
      "name": "main.tsx",
      "grid": [
        "#####################",
        "#●  #   #     #     #",
        "### # # # ### # ### #",
        "#   # # #   #   #   #",
        "# ### # ##### ### # #",
        "#   #   #     #   # #",
        "# # ##### ### # ### #",
        "# #       #   #   ★ #",
        "#####################"
      ]
    },
    {
      "name": "App.tsx",
      "grid": [
        "#########################",
        "#●                      #",
        "####################### #",
        "#                       #",
        "# #######################",
        "#                       #",
        "####################### #",
        "#                       #",
        "# #######################",
        "#                     ★ #",
        "#########################"
      ]
    },
    {
      "name": "router.ts",
      "grid": [
        "#############################",
        "#●                          #",
        "########################### #",
        "#                           #",
        "# ###########################",
        "#                           #",
        "########################### #",
        "#                           #",
        "# ###########################",
        "#                           #",
        "########################### #",
        "#                         ★ #",
        "#############################"
      ]
    }
  ]
}
